00200000000000000020
00000000000000000000
00000000000000000000
00000000000000000000
00000000000000000000
00000000000000000000
00000000000000000000
00000000000000000000
00000033330033330000
00000000000000000000
00000000000000000000
00000000000000000000
00000000000000000000
00000000000000000000
00000000000000000000
00000033330000000000
00000000000000000000
00000000000000000000
00000000000000000000
03333000000003333000

