|2000000000000000003|
|uuuu-uuuu-uuuu-uuuu|
|1111111111111111111|
|1111111111111111111|
|0000000000000000000|
|-------------------|
|1111111111111111111|
|1111111111111111111|
|0000000000000000000|
|ssss-ssss-ssss-ssss|
|1111111111111111111|
|1111111111111111111|
|0000000000000000000|
|-------------------|
|1111111111111111111|
|1111111111111111111|
|0000000000000000000|
|hhhh-hhhh-hhhh-hhhh|
|1111111111111111111|
|1111111111111111111|
|000000000p000000000|
|-------------------|
111111111111111111111
111111111111111111111
111111111111111111111
1dddd1dddd1dddd1dddd1


