-uuuu-uuuu-uuuu-uuuu-
|0000000000000000000|
|0000000000000000000|
---------------------
|0000000000000000000|
|0000000000000000000|
|0000000000000000000|
-ssss-ssss-ssss-ssss-
|0000000000000000000|
|0000000000000000000|
|0000000000000000000|
---------------------
|0000000000000000000|
|0000000000000000000|
|0000000000000000000|
-hhhh-hhhh-hhhh-hhhh-
|0000000000000000000|
|0000000000000000000|
|0000000000000000000|
-dddd-dddd-dddd-dddd-
000000000000000000000
000000000000000000000
000000000000000000000
000000000000000000000
0____0____0____0____0

