---------------------
|0000000000000000000|
|0000000000000000000|
---------------------
|0000000000000000000|
|0000000000000000000|
|0000000000000000000|
---------------------
|0000000000000000000|
|0000000000000000000|
|0000000000000000000|
---------------------
|0000000000000000000|
|0000000000000000000|
|0000000000000000000|
---------------------
|0000000000000000000|
|0000000000000000000|
|0000000000000000000|
-dddd-dddd-dddd-dddd-
000000000000000000000
000000000000000000000
000000000000000000000
000000000000000000000
0____0____0____0____0

