|2000|0000|0000|0003|        
|uuuu|uuuu|uuuu|uuuu|
|1111|1111|1111|1111|
|1111|1111|1111|1111|
|1111|1111|0000|0000|
|1111|1111|ssss|ssss|
|1111|1111|1111|11111
|1111|1111|1111|11111
|0000|1111|1111|11111
|ssss|1111|1111|11111
|1111|1111|1111|11111
|1111|1111|1111|11111
|1111|0000|0000|00p00
|1111|ssss|hhhh|-----
|111111111|1111|11111
|111111111|1111|11111
|0000|0000|1111|11111
|hhhh|hhhh|1111|0000|
|1111|1111|1111|hhhh|
|1111|1111|1111|1111|
|0000|0000|0000|0000|
|dddd|dddd|dddd|dddd|
111111111111111111111
111111111111111111111
111111111111111111111
1----1----1----1----1
